11111111111011111111111
10001000001010000010001
10001000001010000010001
11111111111111111111111
10001010001010001010001

